0 0 0 0 0 0 0 0 0 0 0 0 0 0 0 0
0 0 0 0 m m m m m m m 0 0 0 0 0
0 0 0 0 m s s s s s m 0 0 0 0 0
0 0 0 0 m s f f f s m 0 0 0 0 0
0 0 0 0 m s 0 0 0 s m 0 0 0 0 0
0 0 0 0 m s 0 0 0 s m 0 0 0 0 0
0 0 0 0 m s 0 0 0 s m 0 0 0 0 0
0 0 0 0 m s 0 0 0 s m 0 0 0 0 0
0 0 0 0 m s f f f s m 0 0 0 0 0
0 0 0 0 m s s s s s m 0 0 0 0 0
0 0 0 0 m m m m m m m 0 0 0 0 0
0 0 0 0 0 0 0 0 0 0 0 0 0 0 0 0
