0 0 0 0 0 0 0 0 0 0 0 0 0 0 0 0
0 0 0 0 m m m m m m m 0 0 0 0 0
0 0 0 0 m s s s s s m 0 0 0 0 0
0 0 0 0 m s f f f s m 0 0 0 0 0
0 0 0 0 m s 13 0 23 s m 0 0 0 0 0
0 0 0 0 m s 12 0 22 s m 0 0 0 0 0
0 0 0 0 m s 11 0 21 s m 0 0 0 0 0
0 0 0 0 m s 10 0 20 s m 0 0 0 0 0
0 0 0 0 m s f f f s m 0 0 0 0 0
0 0 0 0 m s s s s s m 0 0 0 0 0
0 0 0 0 m m m m m m m 0 0 0 0 0
0 0 0 0 0 0 0 0 0 0 0 0 0 0 0 0
