20 21 22 23 20 21 22 23 20 21 22 23 20 21 22 23
20 21 22 23 20 21 22 23 20 21 22 23 20 21 22 23
20 21 22 23 20 21 22 23 20 21 22 23 20 21 22 23
20 21 22 23 20 21 22 23 20 21 22 23 20 21 22 23
20 21 22 23 20 21 22 23 20 21 22 23 20 21 22 23
20 21 22 23 20 21 22 23 20 21 22 23 20 21 22 23
20 21 22 23 20 21 22 23 20 21 22 23 20 21 22 23
20 21 22 23 20 21 22 23 20 21 22 23 20 21 22 23
20 21 22 23 20 21 22 23 20 21 22 23 20 21 22 23
20 21 22 23 20 21 22 23 20 21 22 23 20 21 22 23
20 21  0 23 20 21 22 23 20 21 22 23 20 21 22 23
10 21 22 23 20 21 22 23 20 21 22 23 20 21 22 23